11111111111111111111111111111111111111111111111111111
11111111111111111111111111111111111111111111111111111
11111111111111111111111111111111111111111111111111111
11111111111111111111111111111111111111111111111111111
11111111111111111111111111111111111111111111111111111
11111222222200000000000000000000000002222222111111111
11122200000000000000000000000000000000000002222111111
11230000000000000000000000000000000000000000002111111
12330000000000000000000000000000000000000000003211111
12330000000000000000002222000000000000000000003211111
12330000000000000000033333300000000000000000003211111
12330000000000000000033333300000000000000000003211111
11230000000000000000002222000000000000000000002111111
11122200000000000000000000000000000000000002222111111
11111222222200000000000000000000000002222222111111111
11111111111111111111111111111111111111111111111111111
11111111111111111111111111111111111111111111111111111
11111111111111111111111111111111111111111111111111111
11111111111111111111111111111111111111111111111111111
11111111111111111111111111111111111111111111111111111
11111111111111111111111111111111111111111111111111111
